18  0 18  0 18  0 18  0 18  0 18  0 18  0 18  0 18  0 18  0 18  0 18  0 18  0 18  0 18  0 18  0 0   1 0   1 0   1 0   1 0   1 0   1 0   1 0   1 0   1 0   1 0   1 0   1 0   1 0   1 0   1 0   1
18  0 18  0 18  0 18  0 18  0 18  0 18  0 18  0 18  0 18  0 18  0 18  0 18  0 18  0 18  0 18  0 0   1 0   1 0   1 0   1 0   1 0   1 0   1 0   1 0   1 0   1 0   1 0   1 0   1 0   1 0   1 0   1
18  0 18  0 18  0 18  0 18  0 18  0 18  0 18  0 18  0 18  0 18  0 18  0 18  0 18  0 18  0 18  0 0   1 0   1 0   1 0   1 0   1 0   1 0   1 0   1 0   1 0   1 0   1 0   1 0   1 0   1 0   1 0   1
18  0 18  0 18  0 18  0 18  0 18  0 18  0 18  0 18  0 18  0 18  0 18  0 18  0 18  0 18  0 18  0 0   1 0   1 0   1 0   1 0   1 0   1 0   1 0   1 0   1 0   1 0   1 0   1 0   1 0   1 0   1 0   1
18  0 18  0 18  0 18  0 18  0 18  0 18  0 18  0 18  0 18  0 18  0 18  0 18  0 18  0 18  0 18  0 0   1 0   1 0   1 0   1 0   1 0   1 0   1 0   1 0   1 0   1 0   1 0   1 0   1 0   1 0   1 0   1
18  0 18  0 18  0 18  0 18  0 18  0 18  0 18  0 18  0 18  0 18  0 18  0 18  0 18  0 18  0 18  0 0   1 0   1 0   1 0   1 0   1 0   1 0   1 0   1 0   1 0   1 0   1 0   1 0   1 0   1 0   1 0   1
18  0 18  0 18  0 18  0 18  0 18  0 18  0 18  0 18  0 18  0 18  0 18  0 18  0 18  0 18  0 18  0 0   1 0   1 0   1 0   1 0   1 0   1 0   1 0   1 0   1 0   1 0   1 0   1 0   1 0   1 0   1 0   1
18  0 18  0 18  0 18  0 18  0 18  0 18  0 18  0 18  0 18  0 18  0 18  0 18  0 18  0 18  0 18  0 0   1 0   1 0   1 0   1 0   1 0   1 0   1 0   1 0   1 0   1 0   1 0   1 0   1 0   1 0   1 0   1
18  0 18  0 18  0 18  0 18  0 18  0 18  0 18  0 18  0 18  0 18  0 18  0 18  0 18  0 18  0 18  0 0   1 0   1 0   1 0   1 0   1 0   1 0   1 0   1 0   1 0   1 0   1 0   1 0   1 0   1 0   1 0   1
18  0 18  0 18  0 18  0 18  0 18  0 18  0 18  0 18  0 18  0 18  0 18  0 18  0 0   1 0   1 0   1 0   1 0   1 0   1 0   1 0   1 0   1 0   1 0   1 0   1 0   1 0   1 0   1 0   1 0   1 0   1 0   1
18  0 18  0 18  0 18  0 18  0 18  0 18  0 18  0 18  0 18  0 18  0 18  0 18  0 0   1 18  0 18  0 0   1 0   1 0   1 0   1 0   1 0   1 0   1 0   1 0   1 0   1 0   1 0   1 0   1 0   1 0   1 0   1
18  0 18  0 18  0 18  0 18  0 18  0 18  0 18  0 18  0 18  0 18  0 18  0 18  0 0   1 0   1 0   1 0   1 0   1 0   1 0   1 0   1 0   1 0   1 0   1 0   1 0   1 0   1 0   1 0   1 0   1 0   1 0   1
18  0 18  0 18  0 18  0 18  0 18  0 18  0 18  0 18  0 18  0 18  0 18  0 18  0 18  0 18  0 18  0 0   1 0   1 0   1 0   1 0   1 0   1 0   1 0   1 0   1 0   1 0   1 0   1 0   1 0   1 0   1 0   1
18  0 18  0 18  0 18  0 18  0 18  0 18  0 18  0 18  0 18  0 18  0 18  0 18  0 18  0 18  0 18  0 0   1 0   1 0   1 0   1 0   1 0   1 0   1 0   1 0   1 0   1 0   1 0   1 0   1 0   1 0   1 0   1
18  0 18  0 18  0 18  0 18  0 18  0 18  0 18  0 18  0 18  0 18  0 18  0 18  0 18  0 18  0 18  0 0   1 0   1 0   1 0   1 0   1 0   1 0   1 0   1 0   1 0   1 0   1 0   1 0   1 0   1 0   1 0   1
18  0 18  0 18  0 18  0 18  0 18  0 18  0 18  0 18  0 18  0 18  0 18  0 18  0 18  0 18  0 18  0 0   1 0   1 0   1 0   1 0   1 0   1 0   1 0   1 0   1 0   1 0   1 0   1 0   1 0   1 0   1 0   1